%%%%%%%%%%%%
%P%   %%%% %
%        % %
%   %%B%   %
%   %  %  %%
%  %  %%  %% 
% %  % %C%%%
% %  % % %K%
%%%        %
%%%%%%%%%%%%