%%%%%%%%%
%   P   %
% %   % %
% %%% % %
%C  %  B%
% %   % %
%  %% % %
%   K   %
%%%%%%%%%